@@@@@@@@@@@@@@@@@@@@@@@@@@@@@@@@@@@@@@@@@@@@@@@@@@@@@@@@@@@@@@
C..----@~~~~......%%%%.......~~~~~~.........~~~~.~~~~%%%%%%%%@
...----@..........%%%%.......~~~~~~.........~~~~.~~~~%%%%%%%%@
...----@..........%%%%.......~~~~~~...........~~~~~..%%%%%%..@
--------.....................~~~~~~...........~~~~~..%%%%....@
----------...................~~~~~~................%%%%......@
@@@@@@..#--#.................~~~~~~..............%%%%~~~~~...@
~~~~.....#--....~~~.....................~~~~~..%%%%..........@
.....~~~...--#............%%%%...............%%%%..~~~~~.....@
...........#--.....~~~........~~~....~~~~~.%%%%..............@
......~~~....--#.........................%%%%.~~~~~..........@
.............#--.....~~~........~~~~~..%%%%.........~~~......@
........~~~....--#...................%%%%.............%%%%...@
.%%%%..........#--#..#..#..#..#.#..%%%%.#~~~~~...............@
.........~~~.....---------------------------#.....~~~........@
...........~~~..#----------------------------................@
...~~~............#--........####...........--#....~~~.......@
....................---------------------------..............@
..%%%%..~~~.........#---------------------------#...~~~......@
...............~~~~~..%%%%..#.#..#..#..#.#..#.#.--#......~~~~@
..~~~~~............%%%%%%.........................--.#.@@@@@@@
..~~~~~..........%%%%....~~~...~~~~~~..~~~~~......#.---------@
~~~~.~~~~......%%%%............~~~~~................---------@
~~~~.~~~~....%%%%........%%%%..~~~~~......~~~........@----###@
%%%%%%%%%%%%%%........~~~%%%%..~~~~~.................@----#E.@
%%%%%%%%%%...............%%%%..~~~~~.............~~~~@----#..@
@@@@@@@@@@@@@@@@@@@@@@@@@@@@@@@@@@@@@@@@@@@@@@@@@@@@@@@@@@@@@@
..............................................................
..............................................................
..............................................................
..............................................................
